1;1;1;1;1;1;1;1;1;1;1;1;1;1;1;1;1;1;1;1
1;m; ; ; ; ; ; ; ; ; ; ; ; ; ; ; ; ;m;1
1;1;1;1;1;1;1;1;1;1;1;1;1;1;1;1;1;1; ;1
1;m; ; ; ; ; ; ; ; ; ; ; ; ; ; ;m;1; ;1
1; ;1;1;1;1;1;1;1;1;1;1;1;1;1;1; ;1; ;1
1; ;1;m; ; ; ; ; ; ; ; ; ; ;m;1; ;1; ;1
1; ;1; ;1;1;1;1;1;1;1;1;1;1; ;1; ;1; ;1
1; ;1; ;1;m; ; ; ; ; ; ;m;1; ;1; ;1; ;1
1; ;1; ;1; ;1;1;1;1;1;1;1;1; ;1; ;1; ;1
1; ;1; ;1;m; ; ; ; ; ; ; ; ;m;1; ;1; ;1
1; ;1; ;1;1;1;1;1;1;1;1;1;1;1;1; ;1; ;1
1; ;1;m; ; ; ; ; ; ; ; ; ; ; ; ;m;1; ;1
1; ;1;1;1;1;1;1;1;1;1;1;1;1;1;1;1;1; ;1
1;m; ; ; ; ; ; ; ; ; ; ; ; ; ; ; ; ;m;1
1;1;1;1;1;1;1;1;1;1;1;1;1;1;1;1;1;1;1;1
