1;1;1;1;1;1;1;1;1;1;1;1;1;1;1;1;1;1;1;1
1; ; ; ; ; ;1; ; ; ; ; ; ; ; ; ; ; ; ;1
1; ; ; ; ; ;1; ;s;s;s;s;s; ; ; ; ; ; ;1
1; ; ; ; ; ;1; ; ; ; ; ; ; ; ; ; ; ; ;1
1; ; ; ; ; ;1; ; ; ; ; ; ; ; ; ; ; ; ;1
1; ; ; ; ; ;1; ; ; ; ; ; ; ;w; ;w; ; ;1
1; ; ; ; ; ; ; ; ; ; ; ; ; ;w; ;w; ; ;1
1; ; ; ; ; ; ; ; ; ; ; ; ; ;w; ;w; ; ;1
1; ; ; ; ; ; ; ; ; ; ; ; ; ;w; ;w; ; ;1
1; ; ; ; ; ; ; ; ; ;1; ; ; ;w; ;w; ; ;1
1; ; ; ; ; ; ; ; ; ;1; ;m; ;w; ;w; ; ;1
1; ; ; ; ; ; ; ; ; ;1; ;s; ;w; ;w; ; ;1
1; ; ; ; ; ; ; ; ; ;1; ;m; ; ; ; ; ; ;1
1; ; ; ; ; ; ; ; ; ;1; ; ; ; ; ; ; ; ;1
1;1;1;1;1;1;1;1;1;1;1;1;1;1;1;1;1;1;1;1
