1;1;1;1;1;1;1;1;1;1;1;1;1;1;1;1;1;1;1;1
1; ; ; ; ; ; ; ; ; ; ; ; ; ; ; ; ; ; ;1
1; ; ; ; ; ; ; ; ; ; ; ; ; ; ; ; ;s; ;1
1; ; ;1;1;1;1;1; ; ; ;1;1;1;1;1; ; ; ;1
1; ; ;1; ; ; ; ; ; ; ;w; ; ; ; ; ; ; ;1
1; ; ;w; ; ; ;s; ;m; ;w; ; ; ; ;m; ; ;1
1; ; ;w; ; ; ; ; ; ; ;w; ; ; ; ; ; ; ;1
1; ; ;w; ; ; ; ; ; ; ;w; ;s; ; ; ; ; ;1
1; ; ;w; ; ; ; ; ; ; ;w; ; ; ; ; ; ; ;1
1; ; ;w; ; ; ;s; ;m; ;w; ; ; ; ;m; ; ;1
1; ; ;1; ; ; ; ; ; ; ;w; ; ; ; ; ; ; ;1
1; ; ;1;1;1;1;1; ; ; ;1;1;1;1;1; ; ; ;1
1; ; ; ; ; ; ; ; ; ; ; ; ; ; ; ; ;s; ;1
1; ; ; ; ; ; ; ; ; ; ; ; ; ; ; ; ; ; ;1
1;1;1;1;1;1;1;1;1;1;1;1;1;1;1;1;1;1;1;1
