1;1;1;1;1;1;1;1;1;1;1;1;1;1;1;1;1;1;1;1
1;s; ; ;s; ; ; ; ; ; ; ; ; ; ; ; ; ; ;1
1; ;1;1; ; ; ; ; ; ; ; ; ; ; ; ; ; ; ;1
1; ; ; ; ; ; ; ; ;s; ; ;s; ; ;s; ; ; ;1
1;w;w;w;w;w;w;1; ; ; ; ; ; ; ; ; ; ; ;1
1; ; ; ; ; ; ;1; ; ; ; ; ; ; ; ; ; ; ;1
1; ;1;1;w; ; ;1; ; ; ; ; ; ; ; ; ; ; ;1
1; ;w; ;w; ; ;1; ; ; ;m; ;m; ; ; ; ; ;1
1; ;w; ;w; ; ;1; ; ; ; ; ; ; ; ; ; ; ;1
1; ; ; ;w; ; ;1; ; ; ; ; ; ; ; ; ; ; ;1
1; ;w; ;w; ; ;1; ; ; ; ; ; ; ; ; ; ; ;1
1; ;w; ;w; ; ; ; ; ; ; ; ; ; ; ; ; ; ;1
1; ;w; ;w;1;1;w;1;1;w;1;1; ;1;w;w;w;1;1
1; ; ; ; ; ; ; ; ; ; ;m; ;m; ;m; ; ; ;1
1;1;1;1;1;1;1;1;1;1;1;1;1;1;1;1;1;1;1;1
