1;1;1;1;1;1;1;1;1;1;1;1;1;1;1;1;1;1;1;1
1; ; ; ; ; ;1; ; ; ; ; ; ; ; ; ; ; ; ;1
1; ; ; ; ; ;1; ;s; ; ; ; ; ; ; ;s; ; ;1
1; ; ; ; ; ;1; ; ; ; ; ; ; ; ; ; ; ; ;1
1; ; ; ; ; ;1; ; ; ; ; ; ; ; ; ;m; ; ;1
1; ; ; ; ; ;1; ; ; ;1; ; ; ; ; ; ; ; ;1
1; ; ; ; ; ; ; ; ; ;1; ; ; ; ; ; ; ; ;1
1; ; ; ; ; ; ; ; ; ;1; ; ; ; ; ; ; ; ;1
1; ; ; ; ; ; ; ; ; ;1; ; ; ; ; ; ; ; ;1
1; ; ; ; ; ; ; ; ; ;1; ; ; ; ; ; ; ; ;1
1; ; ; ; ; ; ; ; ; ; ; ;m; ; ; ;s; ; ;1
1; ; ; ; ; ; ; ; ; ; ; ; ; ;1; ; ; ; ;1
1; ; ; ; ; ; ; ; ; ; ; ;s; ;1; ;s; ; ;1
1; ; ; ; ; ; ; ; ; ; ; ; ; ;1; ; ; ; ;1
1;1;1;1;1;1;1;1;1;1;1;1;1;1;1;1;1;1;1;1
